1111111111111111111111111
1E000000000000000000001P1
100C0C000C0000C000000C101
100CCC00CCC000C00000CCC01
100C0C0C000C00CCC00C000C1
1111111111111111111111111
